468, 371
771, 506, 752
135, 515, 310, 398
414, 152, 531, 372, 796
298, 551, 746, 648, 126, 205
829, 181, 753, 287, 611, 334, 176
533, 119, 384, 518, 787, 756, 298, 746
790, 50,  652, 371, 425, 293, 443, 322, 192
573, 555, 776, 415, 376, 651, 312, 577, 549, 225
414, 50, 170, 139, 701, 246, 167, 414, 377, 714, 785
811, 318, 710, 466, 741, 137, 455, 570, 441, 237, 197, 334
547, 262, 150, 316, 794, 705, 263, 191, 736, 572, 360, 684, 503
131, 245, 686, 155, 109, 274, 101, 678, 639, 550, 673, 300, 791, 103
554, 434, 155, 618, 557, 800, 350, 506, 206, 172, 130, 670, 709, 492, 452
100, 62,  795, 480, 267, 352, 349, 770, 695, 261, 637, 185, 484, 652, 618, 353